//MAP CONVERTED BY dmm2tgm.py THIS HEADER COMMENT PREVENTS RECONVERSION, DO NOT REMOVE
"aA" = (
/obj/effect/decal/cleanable/glass,
/turf/open/floor/plating,
/area/shuttle)
"aH" = (
/obj/structure/table,
/obj/item/storage/medkit/emergency,
/turf/open/floor/plating,
/area/shuttle)
"bD" = (
/obj/effect/spawner/random/trash/moisture_trap,
/turf/open/floor/plating,
/area/shuttle)
"bE" = (
/obj/effect/decal/cleanable/dirt/dust,
/obj/structure/railing,
/turf/open/floor/plating,
/area/shuttle)
"bV" = (
/obj/effect/decal/cleanable/cobweb/cobweb2,
/turf/open/floor/bronze/filled,
/area/shuttle)
"cd" = (
/obj/effect/decal/cleanable/ants,
/turf/open/floor/plating,
/area/shuttle)
"cg" = (
/obj/item/banner/engineering,
/turf/open/floor/plating,
/area/shuttle)
"db" = (
/obj/structure/closet/crate/necropolis,
/turf/open/floor/plating,
/area/shuttle)
"de" = (
/obj/effect/decal/cleanable/vomit,
/turf/open/floor/plating,
/area/shuttle)
"dE" = (
/turf/closed/wall/mineral/plastitanium,
/area/shuttle)
"dT" = (
/turf/template_noop,
/area/template_noop)
"ex" = (
/obj/structure/statue/sandstone/venus{
	anchored = 1
	},
/turf/open/floor/bronze/filled,
/area/shuttle)
"eB" = (
/obj/effect/spawner/random/structure/crate_abandoned,
/obj/machinery/light/dim/directional/north,
/obj/effect/spawner/random/maintenance/five,
/turf/open/floor/plating,
/area/shuttle)
"eG" = (
/obj/machinery/power/shuttle_engine/large,
/turf/open/floor/plating/airless,
/area/shuttle)
"eJ" = (
/obj/effect/decal/cleanable/dirt/dust,
/obj/machinery/light/small/broken/directional/north,
/turf/open/floor/plating,
/area/shuttle)
"eN" = (
/obj/structure/railing,
/obj/effect/decal/cleanable/dirt/dust,
/obj/effect/spawner/random/maintenance/two,
/turf/open/floor/plating,
/area/shuttle)
"fP" = (
/obj/structure/table/wood/fancy/black,
/obj/item/reagent_containers/cup/glass/drinkingglass,
/obj/item/reagent_containers/cup/glass/drinkingglass,
/obj/item/reagent_containers/cup/glass/drinkingglass,
/obj/item/reagent_containers/cup/glass/drinkingglass,
/obj/effect/decal/cleanable/dirt/dust,
/turf/open/floor/plating,
/area/shuttle)
"gc" = (
/obj/machinery/portable_atmospherics/canister/miasma,
/turf/open/floor/plating,
/area/shuttle)
"gv" = (
/obj/effect/decal/cleanable/blood,
/obj/machinery/light/dim/directional/west,
/turf/open/floor/plating,
/area/shuttle)
"gV" = (
/obj/effect/spawner/random/trash/grille_or_waste,
/turf/open/floor/plating,
/area/shuttle)
"hx" = (
/obj/machinery/light/dim/directional/south,
/turf/open/chasm,
/area/shuttle)
"iA" = (
/obj/effect/decal/cleanable/dirt/dust,
/turf/open/floor/bronze/filled,
/area/shuttle)
"iH" = (
/obj/structure/table/wood/fancy/black,
/obj/machinery/chem_dispenser/drinks/beer/fullupgrade,
/turf/open/floor/plating,
/area/shuttle)
"jh" = (
/obj/effect/decal/cleanable/dirt/dust,
/obj/effect/decal/cleanable/oil,
/turf/open/floor/plating,
/area/shuttle)
"js" = (
/obj/item/banner/medical,
/turf/open/floor/plating,
/area/shuttle)
"kf" = (
/obj/machinery/door/airlock/shuttle,
/turf/open/floor/plating,
/area/shuttle)
"ki" = (
/obj/machinery/light/floor,
/turf/open/floor/plating,
/area/shuttle)
"lD" = (
/obj/structure/closet/wardrobe/cargotech,
/obj/effect/spawner/random/maintenance/eight,
/turf/open/floor/plating,
/area/shuttle)
"lQ" = (
/obj/effect/spawner/random/trash/grille_or_waste,
/obj/effect/decal/cleanable/dirt/dust,
/turf/open/floor/plating,
/area/shuttle)
"lR" = (
/obj/effect/decal/cleanable/dirt/dust,
/obj/item/shard,
/obj/effect/spawner/random/maintenance/eight,
/turf/open/floor/plating,
/area/shuttle)
"mi" = (
/obj/structure/table/wood/fancy/black,
/obj/item/food/pizza/mothic_five_cheese,
/obj/item/food/moth_cheese_cakes,
/turf/open/floor/plating,
/area/shuttle)
"np" = (
/obj/structure/table/wood/fancy/black,
/obj/item/food/philly_cheesesteak,
/obj/item/food/cheese_sandwich,
/turf/open/floor/plating,
/area/shuttle)
"nB" = (
/obj/effect/spawner/random/trash/cigbutt,
/turf/open/floor/plating,
/area/shuttle)
"nF" = (
/obj/effect/spawner/random/structure/crate_loot,
/obj/effect/spawner/random/exotic/syndie,
/obj/effect/spawner/random/maintenance/eight,
/turf/open/floor/plating,
/area/shuttle)
"oK" = (
/turf/open/floor/plating,
/area/shuttle)
"oR" = (
/obj/machinery/computer/emergency_shuttle,
/turf/open/floor/bronze/filled,
/area/shuttle)
"po" = (
/obj/structure/holosign/barrier/atmos,
/turf/open/floor/plating,
/area/shuttle)
"pC" = (
/obj/machinery/power/shuttle_engine/heater,
/turf/open/floor/plating/airless,
/area/shuttle)
"pH" = (
/obj/effect/spawner/random/structure/closet_maintenance,
/obj/effect/spawner/random/maintenance/eight,
/turf/open/floor/plating,
/area/shuttle)
"pQ" = (
/obj/effect/decal/cleanable/blood,
/turf/open/floor/plating,
/area/shuttle)
"qT" = (
/obj/machinery/light/dim/directional/west,
/turf/open/floor/plating,
/area/shuttle)
"rI" = (
/obj/structure/steam_vent,
/turf/open/floor/plating,
/area/shuttle)
"sH" = (
/obj/machinery/door/airlock/shuttle,
/obj/effect/spawner/random/structure/steam_vent,
/turf/open/floor/plating,
/area/shuttle)
"tc" = (
/obj/structure/sign/departments/engineering,
/turf/closed/wall,
/area/shuttle)
"tl" = (
/obj/effect/spawner/random/structure/barricade,
/turf/open/floor/plating,
/area/shuttle)
"tJ" = (
/obj/machinery/light/small/broken/directional/north,
/turf/open/floor/plating,
/area/shuttle)
"tY" = (
/obj/structure/sign/departments/security,
/turf/closed/wall,
/area/shuttle)
"ub" = (
/obj/item/banner/cargo,
/turf/open/floor/plating,
/area/shuttle)
"uy" = (
/obj/effect/decal/cleanable/cobweb,
/turf/open/floor/bronze/filled,
/area/shuttle)
"we" = (
/obj/structure/table/wood/fancy/black,
/obj/item/reagent_containers/cup/glass/drinkingglass/shotglass,
/obj/item/reagent_containers/cup/glass/drinkingglass/shotglass,
/obj/item/reagent_containers/cup/glass/drinkingglass/shotglass,
/obj/item/reagent_containers/cup/glass/drinkingglass/shotglass,
/obj/item/reagent_containers/cup/glass/drinkingglass/shotglass,
/turf/open/floor/plating,
/area/shuttle)
"wC" = (
/obj/structure/guillotine,
/obj/effect/decal/cleanable/blood,
/turf/open/floor/plating,
/area/shuttle)
"wD" = (
/obj/structure/railing,
/obj/effect/decal/cleanable/dirt/dust,
/obj/effect/decal/cleanable/vomit,
/turf/open/floor/plating,
/area/shuttle)
"xL" = (
/mob/living/basic/mouse/rat{
	name = "Royal Ratainer"
	},
/turf/open/floor/carpet/royalblack,
/area/shuttle)
"xV" = (
/obj/effect/decal/cleanable/dirt/dust,
/obj/effect/decal/cleanable/glass,
/turf/open/floor/plating,
/area/shuttle)
"ym" = (
/obj/structure/statue/sandstone/venus{
	dir = 1;
	anchored = 1
	},
/turf/open/floor/bronze/filled,
/area/shuttle)
"zl" = (
/obj/structure/table/wood/fancy/black,
/obj/item/food/cheese/wheel,
/obj/item/food/cheese/wheel,
/obj/item/food/cheese/wheel,
/obj/item/food/cheese/wheel,
/turf/open/floor/plating,
/area/shuttle)
"zq" = (
/obj/effect/spawner/random/maintenance/two,
/turf/open/floor/plating,
/area/shuttle)
"Al" = (
/obj/machinery/portable_atmospherics/canister/miasma,
/obj/machinery/light/dim/directional/east,
/turf/open/floor/plating,
/area/shuttle)
"Au" = (
/obj/machinery/light/dim/directional/west,
/obj/structure/steam_vent,
/turf/open/floor/plating,
/area/shuttle)
"AM" = (
/obj/effect/decal/cleanable/dirt/dust,
/obj/item/shard,
/turf/open/floor/carpet/royalblack,
/area/shuttle)
"AX" = (
/turf/open/floor/carpet/royalblack,
/area/shuttle)
"BW" = (
/obj/effect/spawner/random/trash/moisture_trap,
/obj/effect/decal/cleanable/dirt/dust,
/turf/open/floor/plating,
/area/shuttle)
"Cs" = (
/obj/effect/decal/cleanable/oil/slippery,
/turf/open/floor/carpet/royalblack,
/area/shuttle)
"CD" = (
/obj/effect/decal/cleanable/oil/slippery,
/turf/open/floor/plating,
/area/shuttle)
"CI" = (
/obj/item/shard,
/turf/open/floor/carpet/royalblack,
/area/shuttle)
"Da" = (
/obj/effect/decal/cleanable/dirt/dust,
/obj/structure/steam_vent,
/turf/open/floor/plating,
/area/shuttle)
"Di" = (
/obj/effect/decal/cleanable/dirt/dust,
/turf/open/floor/plating,
/area/shuttle)
"Ef" = (
/obj/effect/decal/cleanable/dirt/dust,
/obj/effect/spawner/random/structure/crate_abandoned,
/obj/effect/spawner/random/maintenance/five,
/turf/open/floor/plating,
/area/shuttle)
"Fj" = (
/obj/structure/table,
/obj/effect/spawner/random/medical/surgery_tool,
/obj/effect/spawner/random/medical/memeorgans,
/obj/machinery/light/dim/directional/south,
/turf/open/floor/plating,
/area/shuttle)
"Fs" = (
/obj/effect/spawner/random/trash/garbage,
/obj/effect/decal/cleanable/dirt/dust,
/turf/open/floor/plating,
/area/shuttle)
"Fy" = (
/obj/effect/decal/cleanable/dirt/dust,
/obj/machinery/light/dim/directional/east,
/obj/structure/steam_vent,
/turf/open/floor/plating,
/area/shuttle)
"FJ" = (
/obj/structure/table/wood/fancy/black,
/obj/item/food/cheese/wheel,
/obj/item/food/cheese/wheel,
/obj/item/food/bread/creamcheese,
/turf/open/floor/plating,
/area/shuttle)
"Hq" = (
/obj/effect/decal/cleanable/dirt/dust,
/obj/effect/spawner/random/structure/crate_loot,
/obj/machinery/light/dim/directional/north,
/obj/effect/spawner/random/maintenance/five,
/turf/open/floor/plating,
/area/shuttle)
"HE" = (
/obj/effect/spawner/random/trash/graffiti,
/turf/open/floor/plating,
/area/shuttle)
"HI" = (
/obj/machinery/light/dim/directional/north,
/turf/open/floor/plating,
/area/shuttle)
"Ii" = (
/turf/open/floor/plating/airless,
/area/shuttle)
"Ij" = (
/obj/effect/spawner/random/structure/crate_loot,
/obj/effect/spawner/random/maintenance/five,
/turf/open/floor/plating,
/area/shuttle)
"Jg" = (
/obj/item/shard,
/turf/open/floor/plating,
/area/shuttle)
"Ji" = (
/obj/effect/decal/cleanable/dirt/dust,
/obj/effect/decal/cleanable/ants/fire,
/turf/open/floor/plating,
/area/shuttle)
"Jt" = (
/obj/machinery/door/airlock/maintenance_hatch,
/turf/open/floor/plating,
/area/shuttle)
"Ju" = (
/obj/structure/table/wood/fancy/black,
/obj/machinery/nuclearbomb/beer,
/turf/open/floor/plating,
/area/shuttle)
"Kx" = (
/obj/structure/sign/departments/cargo,
/turf/closed/wall,
/area/shuttle)
"Lo" = (
/obj/effect/spawner/random/trash/food_packaging,
/turf/open/floor/plating,
/area/shuttle)
"LN" = (
/obj/structure/table/wood/fancy/black,
/obj/machinery/chem_dispenser/drinks/fullupgrade,
/turf/open/floor/plating,
/area/shuttle)
"Ma" = (
/obj/effect/spawner/structure/window/reinforced/plasma/plastitanium,
/turf/open/floor/plating,
/area/shuttle)
"Ne" = (
/obj/effect/decal/cleanable/glass,
/obj/machinery/light/dim/directional/north,
/turf/open/floor/plating,
/area/shuttle)
"NN" = (
/obj/machinery/power/emitter,
/turf/open/floor/plating,
/area/shuttle)
"NV" = (
/obj/effect/decal/cleanable/dirt/dust,
/obj/effect/spawner/random/trash/hobo_squat,
/turf/open/floor/plating,
/area/shuttle)
"OF" = (
/obj/structure/table/wood/fancy/black,
/obj/item/food/baked_cheese_platter,
/obj/item/food/spaghetti/mac_n_cheese,
/turf/open/floor/plating,
/area/shuttle)
"OS" = (
/obj/effect/decal/cleanable/dirt/dust,
/obj/effect/spawner/random/structure/barricade,
/turf/open/floor/plating,
/area/shuttle)
"Pd" = (
/obj/structure/table/wood/fancy/black,
/obj/item/food/baked_cheese,
/obj/item/food/baked_cheese,
/obj/item/food/burger/cheese,
/obj/item/food/ready_donk/mac_n_cheese,
/turf/open/floor/plating,
/area/shuttle)
"Pe" = (
/obj/effect/decal/cleanable/oil,
/turf/open/floor/plating,
/area/shuttle)
"PV" = (
/obj/structure/table/wood/fancy/black,
/obj/item/reagent_containers/cup/glass/bottle/hooch,
/obj/item/reagent_containers/cup/glass/bottle/hooch,
/obj/item/reagent_containers/cup/glass/bottle/hooch,
/turf/open/floor/plating,
/area/shuttle)
"PX" = (
/turf/open/chasm,
/area/shuttle)
"Qb" = (
/obj/effect/decal/cleanable/dirt/dust,
/obj/effect/decal/cleanable/vomit,
/turf/open/floor/plating,
/area/shuttle)
"Qk" = (
/obj/structure/sign/departments/medbay/alt,
/turf/closed/wall,
/area/shuttle)
"Qx" = (
/obj/effect/decal/cleanable/dirt/dust,
/obj/effect/spawner/random/trash/cigbutt,
/turf/open/floor/plating,
/area/shuttle)
"QZ" = (
/obj/effect/spawner/random/structure/crate_loot,
/obj/effect/spawner/random/exotic/antag_gear_weak,
/turf/open/floor/plating,
/area/shuttle)
"RB" = (
/obj/effect/spawner/random/trash/mopbucket,
/turf/open/floor/plating,
/area/shuttle)
"RI" = (
/obj/structure/chair/bronze,
/mob/living/simple_animal/hostile/regalrat/controlled{
	name = "Maintenance Tsar"
	},
/obj/effect/fun_balloon/sentience/emergency_shuttle,
/turf/open/floor/bronze/filled,
/area/shuttle)
"RU" = (
/obj/effect/decal/cleanable/dirt/dust,
/obj/machinery/light/dim/directional/east,
/turf/open/floor/plating,
/area/shuttle)
"Sa" = (
/obj/structure/table,
/obj/effect/spawner/random/medical/medkit,
/turf/open/floor/plating,
/area/shuttle)
"Sl" = (
/obj/effect/spawner/random/trash/box,
/turf/open/floor/plating,
/area/shuttle)
"Sv" = (
/turf/closed/wall,
/area/shuttle)
"Sy" = (
/obj/structure/bonfire/prelit,
/turf/open/floor/plating,
/area/shuttle)
"SB" = (
/obj/effect/spawner/random/trash/garbage,
/turf/open/floor/plating,
/area/shuttle)
"Up" = (
/obj/machinery/door/airlock/shuttle,
/obj/docking_port/mobile/emergency,
/turf/open/floor/plating,
/area/shuttle)
"Va" = (
/obj/effect/spawner/random/trash/caution_sign,
/obj/item/shard,
/obj/effect/spawner/random/maintenance/eight,
/turf/open/floor/plating,
/area/shuttle)
"Vm" = (
/obj/effect/decal/cleanable/dirt/dust,
/obj/effect/spawner/random/trash/food_packaging,
/turf/open/floor/plating,
/area/shuttle)
"VA" = (
/obj/effect/decal/cleanable/dirt/dust,
/turf/open/floor/carpet/royalblack,
/area/shuttle)
"WW" = (
/obj/effect/decal/cleanable/dirt/dust,
/obj/item/shard,
/turf/open/floor/plating,
/area/shuttle)
"WX" = (
/obj/effect/spawner/random/trash/hobo_squat,
/turf/open/floor/plating,
/area/shuttle)
"XH" = (
/obj/effect/spawner/random/trash/janitor_supplies,
/turf/open/floor/plating,
/area/shuttle)
"XK" = (
/turf/open/floor/bronze/filled,
/area/shuttle)
"Yi" = (
/obj/structure/showcase/machinery/cloning_pod,
/turf/open/floor/plating,
/area/shuttle)
"Yo" = (
/obj/effect/decal/cleanable/dirt/dust,
/obj/effect/spawner/random/trash/garbage,
/turf/open/floor/plating,
/area/shuttle)
"ZT" = (
/obj/machinery/power/shuttle_engine/huge,
/turf/open/floor/plating/airless,
/area/shuttle)

(1,1,1) = {"
dT
dT
dT
dT
dT
dT
dT
dT
dE
kf
dE
Up
dE
dT
dT
dT
dE
kf
dE
kf
dE
dT
dT
dT
dT
"}
(2,1,1) = {"
dT
dT
dT
dT
dT
dT
dT
dT
dE
oK
ki
oK
dE
dT
dT
dT
dE
oK
ki
oK
dE
dT
dT
dT
dT
"}
(3,1,1) = {"
dT
dT
dT
dT
dT
dT
dT
dT
dE
oK
oK
oK
dE
dT
dT
dT
dE
oK
oK
oK
dE
dT
dT
dT
dT
"}
(4,1,1) = {"
dT
dT
dT
dT
dT
dE
dE
dE
dE
sH
dE
sH
dE
Ma
Ma
Ma
dE
sH
dE
sH
dE
dT
dT
dT
dT
"}
(5,1,1) = {"
dT
dT
dT
dT
dT
dE
wC
gv
Sv
Di
Di
Di
Yo
xV
RU
Di
HE
oK
oK
oK
dE
dE
dE
dT
dT
"}
(6,1,1) = {"
dT
dT
dT
dT
dT
dE
wC
pQ
Sv
tJ
CD
Sv
Sv
Sv
Sv
Sv
XH
RB
Va
oK
Ma
pC
Ii
eG
dT
"}
(7,1,1) = {"
dT
dT
dT
dT
dE
dE
oK
oK
Sv
tl
tl
Sv
Yi
Yi
Yi
Sv
Sv
Sv
Sv
jh
Ma
pC
Ii
Ii
dT
"}
(8,1,1) = {"
dT
dT
dT
dT
dE
Sl
gV
SB
tY
xV
Di
Sv
js
oK
Di
BW
Di
aH
Sv
Di
dE
dE
dE
dT
dT
"}
(9,1,1) = {"
dT
dT
dT
dT
dE
SB
aA
de
Sv
Di
xV
Qk
WX
oK
Di
Di
oK
Fj
Sv
Fs
Ma
pC
Ii
eG
dT
"}
(10,1,1) = {"
dT
dT
dT
dE
dE
tY
Jt
tY
Sv
HE
oK
Jt
oK
aA
SB
zq
Jg
Sa
Sv
Di
Ma
pC
Ii
Ii
dT
"}
(11,1,1) = {"
dT
dT
dT
dE
Ij
jh
Di
oK
tl
aA
oK
Sv
Sv
Sv
Sv
Sv
Sv
Sv
Sv
xV
dE
dE
dE
dT
dT
"}
(12,1,1) = {"
dT
dT
dT
dE
eB
WW
WW
Lo
oK
oK
Pe
oK
nB
oK
Au
oK
oK
de
oK
Di
Ma
pC
Ii
eG
dT
"}
(13,1,1) = {"
dT
dT
dE
dE
Sv
Sv
Sv
Sv
Sv
Ma
Ma
Sv
Sv
Sv
Sv
Sv
Sv
Sv
Sv
oK
Ma
pC
Ii
Ii
dT
"}
(14,1,1) = {"
dT
dT
dE
pH
oK
Di
oK
oK
gV
Ij
nF
oK
aA
oK
zl
FJ
Pd
OF
Sv
rI
dE
dE
dE
dT
dT
"}
(15,1,1) = {"
dT
dT
dE
pH
Di
aA
gV
CD
xV
Di
oK
oK
gV
de
oK
oK
oK
np
Sv
oK
Ma
pC
Ii
eG
dT
"}
(16,1,1) = {"
dT
dT
dE
Di
lQ
oK
oK
cd
Di
Di
HE
oK
CD
oK
de
gV
oK
mi
Sv
Ne
Ma
pC
Ii
Ii
dT
"}
(17,1,1) = {"
dE
dE
dE
Di
oK
Sy
HE
oK
Sy
Di
oK
Sy
oK
aA
Sy
oK
Di
Sy
Sv
Jt
dE
dE
dE
dT
dT
"}
(18,1,1) = {"
Ma
uy
iA
XK
ex
xL
AX
AX
AX
AX
AX
AX
Cs
AX
VA
VA
VA
CI
AX
AX
Ma
pC
Ii
Ii
ZT
"}
(19,1,1) = {"
Ma
oR
iA
iA
RI
AX
AX
AX
VA
VA
AX
AX
AX
AX
VA
VA
VA
AX
AX
AX
Ma
pC
Ii
Ii
Ii
"}
(20,1,1) = {"
Ma
bV
iA
XK
ym
xL
AX
AX
AX
VA
AM
AX
AX
AX
AX
AX
Cs
AX
AX
AX
Ma
pC
Ii
Ii
Ii
"}
(21,1,1) = {"
dE
dE
dE
oK
oK
Sy
oK
oK
Sy
Di
Di
Sy
aA
oK
Sy
oK
oK
Sy
Sv
Jt
dE
dE
dE
dT
dT
"}
(22,1,1) = {"
dT
dT
dE
oK
gV
oK
aA
gV
aA
Di
Ji
oK
oK
HE
Di
gV
oK
PV
Sv
HI
Ma
pC
Ii
eG
dT
"}
(23,1,1) = {"
dT
dT
dE
pH
oK
gV
oK
Di
Di
CD
gV
oK
gV
oK
xV
Di
Di
Ju
Sv
Di
Ma
pC
Ii
Ii
dT
"}
(24,1,1) = {"
dT
dT
dE
pH
oK
oK
jh
Di
oK
QZ
Ij
oK
oK
oK
iH
LN
fP
we
Sv
Da
dE
dE
dE
dT
dT
"}
(25,1,1) = {"
dT
dT
dE
dE
Sv
Sv
Sv
Sv
Sv
Ma
Ma
Sv
Sv
Sv
Sv
Sv
Sv
Sv
Sv
Qb
Ma
pC
Ii
eG
dT
"}
(26,1,1) = {"
dT
dT
dT
dE
Hq
Di
Lo
tl
Di
Vm
oK
aA
aA
oK
Fy
Di
Di
oK
SB
Di
Ma
pC
Ii
Ii
dT
"}
(27,1,1) = {"
dT
dT
dT
dE
Ef
OS
oK
oK
oK
Qb
oK
Sv
Sv
Sv
Sv
Sv
Sv
Sv
Sv
WW
dE
dE
dE
dT
dT
"}
(28,1,1) = {"
dT
dT
dT
dE
dE
tc
Jt
tc
Sv
oK
oK
Jt
CD
Qx
eN
PX
PX
PX
Sv
oK
Ma
pC
Ii
eG
dT
"}
(29,1,1) = {"
dT
dT
dT
dT
dE
NN
oK
cg
Sv
oK
aA
Kx
ub
Di
bE
PX
PX
hx
Sv
oK
Ma
pC
Ii
Ii
dT
"}
(30,1,1) = {"
dT
dT
dT
dT
dE
NN
oK
aA
tc
Jg
oK
Sv
lD
Di
wD
PX
PX
PX
Sv
aA
dE
dE
dE
dT
dT
"}
(31,1,1) = {"
dT
dT
dT
dT
dE
dE
po
po
Sv
tl
tl
Sv
lD
HE
db
Sv
Sv
Sv
Sv
oK
Ma
pC
Ii
eG
dT
"}
(32,1,1) = {"
dT
dT
dT
dT
dT
dE
gc
gc
Sv
eJ
Di
Sv
Sv
Sv
Sv
Sv
bD
lR
NV
Di
Ma
pC
Ii
Ii
dT
"}
(33,1,1) = {"
dT
dT
dT
dT
dT
dE
gc
Al
Sv
oK
Vm
Di
oK
Lo
qT
oK
oK
xV
oK
Di
dE
dE
dE
dT
dT
"}
(34,1,1) = {"
dT
dT
dT
dT
dT
dE
dE
dE
dE
sH
dE
sH
dE
Ma
Ma
Ma
dE
sH
dE
sH
dE
dT
dT
dT
dT
"}
(35,1,1) = {"
dT
dT
dT
dT
dT
dT
dT
dT
dE
oK
oK
oK
dE
dT
dT
dT
dE
oK
oK
oK
dE
dT
dT
dT
dT
"}
(36,1,1) = {"
dT
dT
dT
dT
dT
dT
dT
dT
dE
oK
ki
oK
dE
dT
dT
dT
dE
oK
ki
oK
dE
dT
dT
dT
dT
"}
(37,1,1) = {"
dT
dT
dT
dT
dT
dT
dT
dT
dE
kf
dE
kf
dE
dT
dT
dT
dE
kf
dE
kf
dE
dT
dT
dT
dT
"}
