//MAP CONVERTED BY dmm2tgm.py THIS HEADER COMMENT PREVENTS RECONVERSION, DO NOT REMOVE
"a" = (
/turf/closed/wall/mineral/titanium,
/area/shuttle/escape)
"b" = (
/obj/item/kirbyplants/random,
/obj/machinery/status_display/evac/directional/east,
/turf/open/floor/mineral/titanium/white,
/area/shuttle/escape)
"d" = (
/obj/effect/fun_balloon/sentience/emergency_shuttle{
	group_name = "OES Captain"
	},
/turf/open/floor/mineral/titanium/white,
/area/shuttle/escape)
"e" = (
/obj/machinery/light/directional/south,
/obj/structure/table/reinforced,
/obj/effect/spawner/random/medical/medkit_rare,
/obj/item/crowbar,
/turf/open/floor/mineral/titanium/white,
/area/shuttle/escape)
"f" = (
/obj/machinery/computer/crew{
	dir = 4
	},
/turf/open/floor/mineral/titanium/white,
/area/shuttle/escape)
"g" = (
/obj/structure/chair/comfy/shuttle{
	dir = 4
	},
/turf/open/floor/mineral/titanium/white,
/area/shuttle/escape)
"h" = (
/obj/machinery/button/flasher{
	id = "ssssssbridgeflash";
	pixel_x = -26;
	pixel_y = 24
	},
/turf/open/floor/mineral/titanium/white,
/area/shuttle/escape)
"i" = (
/obj/machinery/light/directional/north,
/obj/structure/table/reinforced,
/obj/machinery/recharger,
/obj/effect/spawner/random/entertainment/toy_figure,
/turf/open/floor/mineral/titanium/white,
/area/shuttle/escape)
"k" = (
/obj/machinery/light/directional/north,
/obj/structure/table/reinforced,
/obj/machinery/recharger,
/obj/effect/spawner/random/entertainment/plushie_delux,
/turf/open/floor/mineral/titanium/white,
/area/shuttle/escape)
"n" = (
/obj/structure/window/reinforced/spawner,
/turf/open/floor/mineral/titanium/white,
/area/shuttle/escape)
"o" = (
/obj/machinery/recharge_station,
/turf/open/floor/mineral/titanium/white,
/area/shuttle/escape)
"q" = (
/obj/machinery/computer/emergency_shuttle,
/turf/open/floor/mineral/titanium/white,
/area/shuttle/escape)
"s" = (
/obj/structure/window/reinforced/spawner/east,
/turf/open/floor/mineral/titanium/white,
/area/shuttle/escape)
"t" = (
/obj/structure/chair/comfy/shuttle{
	dir = 8
	},
/turf/open/floor/mineral/titanium/white,
/area/shuttle/escape)
"u" = (
/turf/template_noop,
/area/template_noop)
"w" = (
/obj/structure/window/reinforced/spawner/north,
/turf/open/floor/mineral/titanium/white,
/area/shuttle/escape)
"x" = (
/obj/item/toy/beach_ball/orb{
	name = "THE ORB";
	pixel_y = 5;
	anchored = 1
	},
/turf/open/indestructible/permalube,
/area/shuttle/escape)
"z" = (
/obj/structure/sign/nanotrasen,
/turf/closed/wall/mineral/titanium,
/area/shuttle/escape)
"A" = (
/obj/machinery/door/airlock/shuttle{
	name = "Emergency Shuttle Airlock"
	},
/obj/docking_port/mobile/emergency{
	dir = 1;
	name = "orb emergency shuttle escape shuttle"
	},
/turf/open/floor/mineral/titanium/white,
/area/shuttle/escape)
"D" = (
/obj/structure/window/reinforced/spawner/west,
/mob/living/basic/amoung{
	ai_controller = null;
	name = "The Captain"
	},
/turf/open/floor/mineral/titanium/white,
/area/shuttle/escape)
"H" = (
/obj/machinery/computer/atmos_alert{
	dir = 8
	},
/turf/open/floor/mineral/titanium/white,
/area/shuttle/escape)
"K" = (
/obj/machinery/light/directional/east,
/obj/structure/fireaxecabinet/directional/east,
/turf/open/floor/mineral/titanium/white,
/area/shuttle/escape)
"L" = (
/obj/structure/chair/comfy/shuttle{
	dir = 1
	},
/turf/open/floor/mineral/titanium/white,
/area/shuttle/escape)
"S" = (
/obj/machinery/door/airlock/command/glass,
/obj/effect/mapping_helpers/airlock/access/all/command/general,
/obj/machinery/door/poddoor/shutters/indestructible,
/turf/open/floor/mineral/titanium/white,
/area/shuttle/escape)
"T" = (
/turf/open/floor/mineral/titanium/white,
/area/shuttle/escape)
"U" = (
/obj/machinery/computer/communications{
	dir = 8
	},
/turf/open/floor/mineral/titanium/white,
/area/shuttle/escape)
"W" = (
/obj/structure/sign/flag/pride/lesbian,
/turf/closed/wall/mineral/titanium,
/area/shuttle/escape)
"X" = (
/obj/machinery/light/directional/south,
/obj/structure/table/reinforced,
/obj/item/storage/medkit/regular{
	pixel_x = 2;
	pixel_y = 3
	},
/obj/item/storage/medkit/fire,
/obj/machinery/cell_charger,
/obj/item/stock_parts/cell/high,
/turf/open/floor/mineral/titanium/white,
/area/shuttle/escape)
"Y" = (
/obj/machinery/light/directional/west,
/obj/item/radio/intercom/directional/west,
/turf/open/floor/mineral/titanium/white,
/area/shuttle/escape)
"Z" = (
/obj/machinery/computer/security{
	dir = 4
	},
/turf/open/floor/mineral/titanium/white,
/area/shuttle/escape)

(1,1,1) = {"
u
u
a
a
S
a
a
a
a
u
"}
(2,1,1) = {"
u
a
a
Z
h
Y
o
f
a
a
"}
(3,1,1) = {"
a
a
i
t
T
s
T
t
e
a
"}
(4,1,1) = {"
z
q
L
T
n
x
w
T
T
A
"}
(5,1,1) = {"
a
a
k
g
d
D
T
g
X
z
"}
(6,1,1) = {"
u
a
a
H
T
K
b
U
a
a
"}
(7,1,1) = {"
u
u
a
a
S
a
a
W
a
u
"}
