//MAP CONVERTED BY dmm2tgm.py THIS HEADER COMMENT PREVENTS RECONVERSION, DO NOT REMOVE
"aA" = (
/obj/effect/decal/cleanable/glass,
/turf/open/floor/plating,
/area/shuttle/escape)
"aH" = (
/obj/structure/table,
/obj/item/storage/medkit/emergency,
/turf/open/floor/plating,
/area/shuttle/escape)
"bf" = (
/obj/effect/decal/cleanable/glass,
/obj/effect/spawner/random/structure/crate,
/obj/effect/spawner/random/maintenance/eight,
/turf/open/floor/plating,
/area/shuttle/escape)
"bi" = (
/obj/effect/decal/cleanable/dirt/dust,
/obj/effect/spawner/random/structure/crate,
/obj/effect/spawner/random/maintenance/eight,
/turf/open/floor/plating,
/area/shuttle/escape)
"bD" = (
/obj/effect/spawner/random/trash/moisture_trap,
/turf/open/floor/plating,
/area/shuttle/escape)
"bE" = (
/obj/effect/decal/cleanable/dirt/dust,
/obj/structure/railing,
/turf/open/floor/plating,
/area/shuttle/escape)
"bV" = (
/obj/effect/decal/cleanable/cobweb/cobweb2,
/turf/open/floor/bronze/filled,
/area/shuttle/escape)
"bY" = (
/obj/effect/spawner/random/structure/crate,
/obj/effect/spawner/random/maintenance/eight,
/turf/open/floor/plating,
/area/shuttle/escape)
"cd" = (
/obj/effect/decal/cleanable/ants,
/turf/open/floor/plating,
/area/shuttle/escape)
"cg" = (
/obj/item/stack/sheet/mineral/uranium/five,
/obj/item/stack/sheet/mineral/uranium/five,
/obj/item/stack/sheet/mineral/uranium/five,
/obj/item/stack/sheet/mineral/uranium/five,
/obj/item/stack/cable_coil,
/obj/item/banner/engineering/mundane,
/turf/open/floor/plating,
/area/shuttle/escape)
"db" = (
/obj/structure/closet/crate/necropolis,
/turf/open/floor/plating,
/area/shuttle/escape)
"de" = (
/obj/effect/decal/cleanable/vomit,
/turf/open/floor/plating,
/area/shuttle/escape)
"dE" = (
/turf/closed/wall/mineral/plastitanium,
/area/shuttle/escape)
"dT" = (
/turf/template_noop,
/area/template_noop)
"ex" = (
/obj/structure/statue/sandstone/venus{
	anchored = 1
	},
/turf/open/floor/bronze/filled,
/area/shuttle/escape)
"eB" = (
/obj/effect/spawner/random/structure/crate_abandoned,
/obj/machinery/light/dim/directional/north,
/obj/effect/spawner/random/maintenance/five,
/turf/open/floor/plating,
/area/shuttle/escape)
"eG" = (
/obj/machinery/power/shuttle_engine/large,
/turf/open/floor/plating/airless,
/area/shuttle/escape)
"eJ" = (
/obj/effect/decal/cleanable/dirt/dust,
/obj/machinery/light/small/broken/directional/north,
/turf/open/floor/plating,
/area/shuttle/escape)
"eN" = (
/obj/structure/railing,
/obj/effect/decal/cleanable/dirt/dust,
/obj/effect/spawner/random/maintenance/two,
/turf/open/floor/plating,
/area/shuttle/escape)
"fP" = (
/obj/structure/table/wood/fancy/black,
/obj/item/reagent_containers/cup/glass/drinkingglass,
/obj/item/reagent_containers/cup/glass/drinkingglass,
/obj/item/reagent_containers/cup/glass/drinkingglass,
/obj/item/reagent_containers/cup/glass/drinkingglass,
/obj/effect/decal/cleanable/dirt/dust,
/turf/open/floor/plating,
/area/shuttle/escape)
"gc" = (
/obj/machinery/portable_atmospherics/canister/miasma,
/turf/open/floor/plating,
/area/shuttle/escape)
"gm" = (
/obj/effect/decal/cleanable/vomit,
/obj/effect/spawner/random/trash/grille_or_waste,
/turf/open/floor/plating,
/area/shuttle/escape)
"gv" = (
/obj/effect/decal/cleanable/blood,
/obj/machinery/light/dim/directional/west,
/turf/open/floor/plating,
/area/shuttle/escape)
"gV" = (
/obj/effect/spawner/random/trash/grille_or_waste,
/turf/open/floor/plating,
/area/shuttle/escape)
"hk" = (
/obj/effect/decal/cleanable/dirt/dust,
/obj/effect/decal/cleanable/oil,
/obj/effect/spawner/random/structure/crate,
/obj/effect/spawner/random/maintenance/eight,
/turf/open/floor/plating,
/area/shuttle/escape)
"iA" = (
/obj/effect/decal/cleanable/dirt/dust,
/turf/open/floor/bronze/filled,
/area/shuttle/escape)
"iH" = (
/obj/structure/table/wood/fancy/black,
/obj/machinery/chem_dispenser/drinks/beer/fullupgrade,
/turf/open/floor/plating,
/area/shuttle/escape)
"jh" = (
/obj/effect/decal/cleanable/dirt/dust,
/obj/effect/decal/cleanable/oil,
/turf/open/floor/plating,
/area/shuttle/escape)
"js" = (
/obj/item/banner/medical/mundane,
/turf/open/floor/plating,
/area/shuttle/escape)
"kf" = (
/obj/machinery/door/airlock/shuttle,
/turf/open/floor/plating,
/area/shuttle/escape)
"ki" = (
/obj/machinery/light/floor,
/turf/open/floor/plating,
/area/shuttle/escape)
"lD" = (
/obj/structure/closet/wardrobe/cargotech,
/obj/effect/spawner/random/maintenance/eight,
/turf/open/floor/plating,
/area/shuttle/escape)
"lQ" = (
/obj/effect/spawner/random/trash/grille_or_waste,
/obj/effect/decal/cleanable/dirt/dust,
/turf/open/floor/plating,
/area/shuttle/escape)
"lR" = (
/obj/effect/decal/cleanable/dirt/dust,
/obj/item/shard,
/obj/effect/spawner/random/maintenance/eight,
/turf/open/floor/plating,
/area/shuttle/escape)
"mi" = (
/obj/structure/table/wood/fancy/black,
/obj/item/food/pizza/mothic_five_cheese,
/obj/item/food/moth_cheese_cakes,
/turf/open/floor/plating,
/area/shuttle/escape)
"np" = (
/obj/structure/table/wood/fancy/black,
/obj/item/food/philly_cheesesteak,
/obj/item/food/cheese_sandwich,
/turf/open/floor/plating,
/area/shuttle/escape)
"nB" = (
/obj/effect/spawner/random/trash/cigbutt,
/turf/open/floor/plating,
/area/shuttle/escape)
"nF" = (
/obj/effect/spawner/random/structure/crate_loot,
/obj/effect/spawner/random/exotic/syndie,
/obj/effect/spawner/random/maintenance/eight,
/turf/open/floor/plating,
/area/shuttle/escape)
"oK" = (
/turf/open/floor/plating,
/area/shuttle/escape)
"oR" = (
/obj/machinery/computer/emergency_shuttle,
/turf/open/floor/bronze/filled,
/area/shuttle/escape)
"po" = (
/obj/structure/holosign/barrier/atmos,
/turf/open/floor/plating,
/area/shuttle/escape)
"pC" = (
/obj/machinery/power/shuttle_engine/heater,
/turf/open/floor/plating/airless,
/area/shuttle/escape)
"pH" = (
/obj/effect/spawner/random/structure/closet_maintenance,
/obj/effect/spawner/random/maintenance/eight,
/turf/open/floor/plating,
/area/shuttle/escape)
"pQ" = (
/obj/effect/decal/cleanable/blood,
/turf/open/floor/plating,
/area/shuttle/escape)
"qT" = (
/obj/machinery/light/dim/directional/west,
/turf/open/floor/plating,
/area/shuttle/escape)
"rB" = (
/obj/item/banner/security/mundane,
/turf/open/floor/plating,
/area/shuttle/escape)
"rI" = (
/obj/structure/steam_vent,
/turf/open/floor/plating,
/area/shuttle/escape)
"sZ" = (
/obj/effect/decal/cleanable/glass,
/obj/structure/statue/bone/rib,
/turf/open/floor/plating,
/area/shuttle/escape)
"tc" = (
/obj/structure/sign/departments/engineering,
/turf/closed/wall,
/area/shuttle/escape)
"tl" = (
/obj/effect/spawner/random/structure/barricade,
/turf/open/floor/plating,
/area/shuttle/escape)
"tJ" = (
/obj/machinery/light/small/broken/directional/north,
/turf/open/floor/plating,
/area/shuttle/escape)
"tY" = (
/obj/structure/sign/departments/security,
/turf/closed/wall,
/area/shuttle/escape)
"ub" = (
/obj/item/banner/cargo/mundane,
/turf/open/floor/plating,
/area/shuttle/escape)
"uy" = (
/obj/effect/decal/cleanable/cobweb,
/turf/open/floor/bronze/filled,
/area/shuttle/escape)
"we" = (
/obj/structure/table/wood/fancy/black,
/obj/item/reagent_containers/cup/glass/drinkingglass/shotglass,
/obj/item/reagent_containers/cup/glass/drinkingglass/shotglass,
/obj/item/reagent_containers/cup/glass/drinkingglass/shotglass,
/obj/item/reagent_containers/cup/glass/drinkingglass/shotglass,
/obj/item/reagent_containers/cup/glass/drinkingglass/shotglass,
/turf/open/floor/plating,
/area/shuttle/escape)
"wC" = (
/obj/structure/guillotine,
/obj/effect/decal/cleanable/blood,
/turf/open/floor/plating,
/area/shuttle/escape)
"wD" = (
/obj/structure/railing,
/obj/effect/decal/cleanable/dirt/dust,
/obj/effect/decal/cleanable/vomit,
/turf/open/floor/plating,
/area/shuttle/escape)
"xL" = (
/mob/living/basic/mouse/rat{
	name = "Royal Ratainer"
	},
/turf/open/floor/carpet/royalblack,
/area/shuttle/escape)
"xV" = (
/obj/effect/decal/cleanable/dirt/dust,
/obj/effect/decal/cleanable/glass,
/turf/open/floor/plating,
/area/shuttle/escape)
"ym" = (
/obj/structure/statue/sandstone/venus{
	dir = 1;
	anchored = 1
	},
/turf/open/floor/bronze/filled,
/area/shuttle/escape)
"yC" = (
/obj/effect/decal/cleanable/dirt/dust,
/obj/effect/spawner/random/trash/grille_or_waste,
/turf/open/floor/plating,
/area/shuttle/escape)
"zl" = (
/obj/structure/table/wood/fancy/black,
/obj/item/food/cheese/wheel,
/obj/item/food/cheese/wheel,
/obj/item/food/cheese/wheel,
/obj/item/food/cheese/wheel,
/turf/open/floor/plating,
/area/shuttle/escape)
"zq" = (
/obj/effect/spawner/random/maintenance/two,
/turf/open/floor/plating,
/area/shuttle/escape)
"Al" = (
/obj/machinery/portable_atmospherics/canister/miasma,
/obj/machinery/light/dim/directional/east,
/turf/open/floor/plating,
/area/shuttle/escape)
"Au" = (
/obj/machinery/light/dim/directional/west,
/obj/structure/steam_vent,
/turf/open/floor/plating,
/area/shuttle/escape)
"AM" = (
/obj/effect/decal/cleanable/dirt/dust,
/obj/item/shard,
/turf/open/floor/carpet/royalblack,
/area/shuttle/escape)
"AX" = (
/turf/open/floor/carpet/royalblack,
/area/shuttle/escape)
"BW" = (
/obj/effect/spawner/random/trash/moisture_trap,
/obj/effect/decal/cleanable/dirt/dust,
/turf/open/floor/plating,
/area/shuttle/escape)
"Cs" = (
/obj/effect/decal/cleanable/oil/slippery,
/turf/open/floor/carpet/royalblack,
/area/shuttle/escape)
"CB" = (
/obj/structure/statue/bone/rib,
/turf/open/floor/plating,
/area/shuttle/escape)
"CD" = (
/obj/effect/decal/cleanable/oil/slippery,
/turf/open/floor/plating,
/area/shuttle/escape)
"CI" = (
/obj/item/shard,
/turf/open/floor/carpet/royalblack,
/area/shuttle/escape)
"Da" = (
/obj/effect/decal/cleanable/dirt/dust,
/obj/structure/steam_vent,
/turf/open/floor/plating,
/area/shuttle/escape)
"Di" = (
/obj/effect/decal/cleanable/dirt/dust,
/turf/open/floor/plating,
/area/shuttle/escape)
"Ef" = (
/obj/effect/decal/cleanable/dirt/dust,
/obj/effect/spawner/random/structure/crate_abandoned,
/obj/effect/spawner/random/maintenance/five,
/turf/open/floor/plating,
/area/shuttle/escape)
"Fj" = (
/obj/structure/table,
/obj/effect/spawner/random/medical/surgery_tool,
/obj/effect/spawner/random/medical/memeorgans,
/obj/machinery/light/dim/directional/south,
/turf/open/floor/plating,
/area/shuttle/escape)
"Fs" = (
/obj/effect/spawner/random/trash/garbage,
/obj/effect/decal/cleanable/dirt/dust,
/turf/open/floor/plating,
/area/shuttle/escape)
"Fy" = (
/obj/effect/decal/cleanable/dirt/dust,
/obj/machinery/light/dim/directional/east,
/obj/structure/steam_vent,
/turf/open/floor/plating,
/area/shuttle/escape)
"FJ" = (
/obj/structure/table/wood/fancy/black,
/obj/item/food/cheese/wheel,
/obj/item/food/cheese/wheel,
/obj/item/food/bread/creamcheese,
/turf/open/floor/plating,
/area/shuttle/escape)
"Hq" = (
/obj/effect/decal/cleanable/dirt/dust,
/obj/effect/spawner/random/structure/crate_loot,
/obj/machinery/light/dim/directional/north,
/obj/effect/spawner/random/maintenance/five,
/turf/open/floor/plating,
/area/shuttle/escape)
"HE" = (
/obj/effect/spawner/random/trash/graffiti,
/turf/open/floor/plating,
/area/shuttle/escape)
"HI" = (
/obj/machinery/light/dim/directional/north,
/turf/open/floor/plating,
/area/shuttle/escape)
"Ii" = (
/turf/open/floor/plating/airless,
/area/shuttle/escape)
"Ij" = (
/obj/effect/spawner/random/structure/crate_loot,
/obj/effect/spawner/random/maintenance/five,
/turf/open/floor/plating,
/area/shuttle/escape)
"Jg" = (
/obj/item/shard,
/turf/open/floor/plating,
/area/shuttle/escape)
"Ji" = (
/obj/effect/decal/cleanable/dirt/dust,
/obj/effect/decal/cleanable/ants/fire,
/turf/open/floor/plating,
/area/shuttle/escape)
"Jt" = (
/obj/machinery/door/airlock/maintenance_hatch,
/turf/open/floor/plating,
/area/shuttle/escape)
"Ju" = (
/obj/structure/table/wood/fancy/black,
/obj/machinery/nuclearbomb/beer,
/turf/open/floor/plating,
/area/shuttle/escape)
"Kx" = (
/obj/structure/sign/departments/cargo,
/turf/closed/wall,
/area/shuttle/escape)
"Lo" = (
/obj/effect/spawner/random/trash/food_packaging,
/turf/open/floor/plating,
/area/shuttle/escape)
"LN" = (
/obj/structure/table/wood/fancy/black,
/obj/machinery/chem_dispenser/drinks/fullupgrade,
/turf/open/floor/plating,
/area/shuttle/escape)
"Ma" = (
/obj/effect/spawner/structure/window/reinforced/plasma/plastitanium,
/turf/open/floor/plating,
/area/shuttle/escape)
"Ne" = (
/obj/effect/decal/cleanable/glass,
/obj/machinery/light/dim/directional/north,
/turf/open/floor/plating,
/area/shuttle/escape)
"NN" = (
/obj/machinery/power/emitter,
/turf/open/floor/plating,
/area/shuttle/escape)
"NV" = (
/obj/effect/decal/cleanable/dirt/dust,
/obj/effect/spawner/random/trash/hobo_squat,
/turf/open/floor/plating,
/area/shuttle/escape)
"OF" = (
/obj/structure/table/wood/fancy/black,
/obj/item/food/baked_cheese_platter,
/obj/item/food/spaghetti/mac_n_cheese,
/turf/open/floor/plating,
/area/shuttle/escape)
"OS" = (
/obj/effect/decal/cleanable/dirt/dust,
/obj/effect/spawner/random/structure/barricade,
/turf/open/floor/plating,
/area/shuttle/escape)
"Pd" = (
/obj/structure/table/wood/fancy/black,
/obj/item/food/baked_cheese,
/obj/item/food/baked_cheese,
/obj/item/food/burger/cheese,
/obj/item/food/ready_donk/mac_n_cheese,
/turf/open/floor/plating,
/area/shuttle/escape)
"Pe" = (
/obj/effect/decal/cleanable/oil,
/turf/open/floor/plating,
/area/shuttle/escape)
"PV" = (
/obj/structure/table/wood/fancy/black,
/obj/item/reagent_containers/cup/glass/bottle/hooch,
/obj/item/reagent_containers/cup/glass/bottle/hooch,
/obj/item/reagent_containers/cup/glass/bottle/hooch,
/turf/open/floor/plating,
/area/shuttle/escape)
"PX" = (
/turf/open/chasm,
/area/shuttle/escape)
"Qb" = (
/obj/effect/decal/cleanable/dirt/dust,
/obj/effect/decal/cleanable/vomit,
/turf/open/floor/plating,
/area/shuttle/escape)
"Qk" = (
/obj/structure/sign/departments/medbay/alt,
/turf/closed/wall,
/area/shuttle/escape)
"Qx" = (
/obj/effect/decal/cleanable/dirt/dust,
/obj/effect/spawner/random/trash/cigbutt,
/obj/machinery/light/dim/directional/west,
/turf/open/floor/plating,
/area/shuttle/escape)
"QZ" = (
/obj/effect/spawner/random/structure/crate_loot,
/obj/effect/spawner/random/exotic/antag_gear_weak,
/obj/effect/spawner/random/maintenance/eight,
/turf/open/floor/plating,
/area/shuttle/escape)
"RB" = (
/obj/effect/spawner/random/trash/mopbucket,
/turf/open/floor/plating,
/area/shuttle/escape)
"RI" = (
/obj/structure/chair/bronze,
/mob/living/simple_animal/hostile/regalrat/controlled{
	name = "Maintenance Tsar"
	},
/obj/effect/fun_balloon/sentience/emergency_shuttle,
/turf/open/floor/bronze/filled,
/area/shuttle/escape)
"RU" = (
/obj/effect/decal/cleanable/dirt/dust,
/obj/machinery/light/dim/directional/east,
/turf/open/floor/plating,
/area/shuttle/escape)
"Sa" = (
/obj/structure/table,
/obj/effect/spawner/random/medical/medkit,
/turf/open/floor/plating,
/area/shuttle/escape)
"Sl" = (
/obj/effect/spawner/random/trash/box,
/turf/open/floor/plating,
/area/shuttle/escape)
"Sv" = (
/turf/closed/wall,
/area/shuttle/escape)
"Sy" = (
/obj/structure/bonfire/prelit,
/turf/open/floor/plating,
/area/shuttle/escape)
"SB" = (
/obj/effect/spawner/random/trash/garbage,
/turf/open/floor/plating,
/area/shuttle/escape)
"Tz" = (
/obj/effect/decal/cleanable/dirt/dust,
/obj/structure/statue/bone/rib,
/turf/open/floor/plating,
/area/shuttle/escape)
"Up" = (
/obj/machinery/door/airlock/shuttle,
/obj/docking_port/mobile/emergency,
/turf/open/floor/plating,
/area/shuttle/escape)
"UW" = (
/obj/effect/decal/cleanable/glass,
/obj/machinery/power/port_gen/pacman/super,
/turf/open/floor/plating,
/area/shuttle/escape)
"Va" = (
/obj/effect/spawner/random/trash/caution_sign,
/obj/item/shard,
/obj/effect/spawner/random/maintenance/eight,
/turf/open/floor/plating,
/area/shuttle/escape)
"Vm" = (
/obj/effect/decal/cleanable/dirt/dust,
/obj/effect/spawner/random/trash/food_packaging,
/turf/open/floor/plating,
/area/shuttle/escape)
"VA" = (
/obj/effect/decal/cleanable/dirt/dust,
/turf/open/floor/carpet/royalblack,
/area/shuttle/escape)
"WW" = (
/obj/effect/decal/cleanable/dirt/dust,
/obj/item/shard,
/turf/open/floor/plating,
/area/shuttle/escape)
"WX" = (
/obj/effect/spawner/random/trash/hobo_squat,
/turf/open/floor/plating,
/area/shuttle/escape)
"XH" = (
/obj/effect/spawner/random/trash/janitor_supplies,
/turf/open/floor/plating,
/area/shuttle/escape)
"XK" = (
/turf/open/floor/bronze/filled,
/area/shuttle/escape)
"Yi" = (
/obj/structure/showcase/machinery/cloning_pod,
/turf/open/floor/plating,
/area/shuttle/escape)
"Yo" = (
/obj/effect/decal/cleanable/dirt/dust,
/obj/effect/spawner/random/trash/garbage,
/turf/open/floor/plating,
/area/shuttle/escape)
"Yz" = (
/obj/effect/spawner/random/engineering/toolbox,
/turf/open/floor/plating,
/area/shuttle/escape)
"ZT" = (
/obj/machinery/power/shuttle_engine/huge,
/turf/open/floor/plating/airless,
/area/shuttle/escape)

(1,1,1) = {"
dT
dT
dT
dT
dT
dT
dT
dT
dE
kf
dE
Up
dE
dT
dT
dT
dE
kf
dE
kf
dE
dT
dT
dT
dT
"}
(2,1,1) = {"
dT
dT
dT
dT
dT
dT
dT
dT
dE
rI
ki
rI
dE
dT
dT
dT
dE
rI
ki
rI
dE
dT
dT
dT
dT
"}
(3,1,1) = {"
dT
dT
dT
dT
dT
dT
dT
dT
dE
oK
oK
oK
dE
dT
dT
dT
dE
oK
oK
oK
dE
dT
dT
dT
dT
"}
(4,1,1) = {"
dT
dT
dT
dT
dT
dE
dE
dE
dE
kf
dE
kf
dE
Ma
Ma
Ma
dE
kf
dE
kf
dE
dT
dT
dT
dT
"}
(5,1,1) = {"
dT
dT
dT
dT
dT
dE
wC
gv
Sv
Di
Di
Di
Yo
xV
RU
Di
HE
oK
oK
oK
dE
dE
dE
dT
dT
"}
(6,1,1) = {"
dT
dT
dT
dT
dT
dE
wC
pQ
Sv
tJ
CD
Sv
Sv
Sv
Sv
Sv
XH
RB
Va
oK
Ma
pC
Ii
eG
dT
"}
(7,1,1) = {"
dT
dT
dT
dT
dE
dE
rB
oK
Sv
tl
tl
Sv
Yi
Yi
Yi
Sv
Sv
Sv
Sv
jh
Ma
pC
Ii
Ii
dT
"}
(8,1,1) = {"
dT
dT
dT
dT
dE
Sl
gV
SB
tY
xV
Di
Sv
js
oK
Di
BW
Di
aH
Sv
Di
dE
dE
dE
dT
dT
"}
(9,1,1) = {"
dT
dT
dT
dT
dE
SB
aA
de
Sv
Di
xV
Qk
WX
oK
Di
Di
oK
Fj
Sv
Fs
Ma
pC
Ii
eG
dT
"}
(10,1,1) = {"
dT
dT
dT
dE
dE
tY
Jt
tY
Sv
HE
oK
Jt
oK
aA
SB
zq
Jg
Sa
Sv
Di
Ma
pC
Ii
Ii
dT
"}
(11,1,1) = {"
dT
dT
dT
dE
Ij
jh
Di
oK
tl
aA
oK
Sv
Sv
Sv
Sv
Sv
Sv
Sv
Sv
xV
dE
dE
dE
dT
dT
"}
(12,1,1) = {"
dT
dT
dT
dE
eB
WW
WW
Lo
oK
oK
Pe
oK
nB
oK
Au
oK
oK
de
oK
Di
Ma
pC
Ii
eG
dT
"}
(13,1,1) = {"
dT
dT
dE
dE
Sv
Sv
Sv
Sv
Sv
Ma
Ma
Sv
Sv
Sv
Sv
Sv
Sv
Sv
Sv
oK
Ma
pC
Ii
Ii
dT
"}
(14,1,1) = {"
dT
dT
dE
pH
oK
Di
bY
bY
gV
Ij
nF
bY
bf
bY
zl
FJ
Pd
OF
Sv
rI
dE
dE
dE
dT
dT
"}
(15,1,1) = {"
dT
dT
dE
pH
Di
aA
gV
CD
xV
Di
oK
oK
gV
de
oK
oK
oK
np
Sv
oK
Ma
pC
Ii
eG
dT
"}
(16,1,1) = {"
dT
dT
dE
Di
lQ
oK
oK
cd
Di
Di
HE
oK
CD
oK
gm
oK
oK
mi
Sv
Ne
Ma
pC
Ii
Ii
dT
"}
(17,1,1) = {"
dE
dE
dE
Di
CB
Sy
HE
CB
Sy
Di
CB
Sy
oK
sZ
Sy
oK
Tz
Sy
Sv
Jt
dE
dE
dE
dT
dT
"}
(18,1,1) = {"
Ma
uy
iA
XK
ex
xL
AX
AX
AX
AX
AX
AX
Cs
AX
VA
VA
VA
CI
AX
AX
Ma
pC
Ii
Ii
ZT
"}
(19,1,1) = {"
Ma
oR
iA
iA
RI
AX
AX
AX
VA
VA
AX
AX
AX
AX
VA
VA
VA
AX
AX
AX
Ma
pC
Ii
Ii
Ii
"}
(20,1,1) = {"
Ma
bV
iA
XK
ym
xL
AX
AX
AX
VA
AM
AX
AX
AX
AX
AX
Cs
AX
AX
AX
Ma
pC
Ii
Ii
Ii
"}
(21,1,1) = {"
dE
dE
dE
oK
CB
Sy
oK
CB
Sy
Di
Tz
Sy
aA
CB
Sy
oK
CB
Sy
Sv
Jt
dE
dE
dE
dT
dT
"}
(22,1,1) = {"
dT
dT
dE
oK
gV
oK
aA
gV
aA
Di
Ji
oK
oK
HE
yC
oK
oK
PV
Sv
HI
Ma
pC
Ii
eG
dT
"}
(23,1,1) = {"
dT
dT
dE
pH
oK
gV
oK
Di
Di
CD
gV
oK
gV
oK
xV
Di
Di
Ju
Sv
Di
Ma
pC
Ii
Ii
dT
"}
(24,1,1) = {"
dT
dT
dE
pH
oK
oK
hk
bi
bY
QZ
Ij
bY
bY
bY
iH
LN
fP
we
Sv
Da
dE
dE
dE
dT
dT
"}
(25,1,1) = {"
dT
dT
dE
dE
Sv
Sv
Sv
Sv
Sv
Ma
Ma
Sv
Sv
Sv
Sv
Sv
Sv
Sv
Sv
Qb
Ma
pC
Ii
eG
dT
"}
(26,1,1) = {"
dT
dT
dT
dE
Hq
Di
Lo
tl
Di
Vm
oK
aA
aA
oK
Fy
Di
Di
oK
SB
Di
Ma
pC
Ii
Ii
dT
"}
(27,1,1) = {"
dT
dT
dT
dE
Ef
OS
oK
oK
oK
Qb
oK
Sv
Sv
Sv
Sv
Sv
Sv
Sv
Sv
WW
dE
dE
dE
dT
dT
"}
(28,1,1) = {"
dT
dT
dT
dE
dE
tc
Jt
tc
Sv
oK
oK
Jt
CD
Qx
eN
PX
PX
PX
Sv
oK
Ma
pC
Ii
eG
dT
"}
(29,1,1) = {"
dT
dT
dT
dT
dE
NN
Yz
cg
Sv
oK
aA
Kx
ub
Di
bE
PX
PX
PX
Sv
oK
Ma
pC
Ii
Ii
dT
"}
(30,1,1) = {"
dT
dT
dT
dT
dE
NN
oK
UW
tc
Jg
oK
Sv
lD
Di
wD
PX
PX
PX
Sv
aA
dE
dE
dE
dT
dT
"}
(31,1,1) = {"
dT
dT
dT
dT
dE
dE
po
po
Sv
tl
tl
Sv
lD
HE
db
Sv
Sv
Sv
Sv
oK
Ma
pC
Ii
eG
dT
"}
(32,1,1) = {"
dT
dT
dT
dT
dT
dE
gc
gc
Sv
eJ
Di
Sv
Sv
Sv
Sv
Sv
bD
lR
NV
Di
Ma
pC
Ii
Ii
dT
"}
(33,1,1) = {"
dT
dT
dT
dT
dT
dE
gc
Al
Sv
oK
Vm
Di
oK
Lo
qT
oK
oK
xV
oK
Di
dE
dE
dE
dT
dT
"}
(34,1,1) = {"
dT
dT
dT
dT
dT
dE
dE
dE
dE
kf
dE
kf
dE
Ma
Ma
Ma
dE
kf
dE
kf
dE
dT
dT
dT
dT
"}
(35,1,1) = {"
dT
dT
dT
dT
dT
dT
dT
dT
dE
oK
oK
oK
dE
dT
dT
dT
dE
oK
oK
oK
dE
dT
dT
dT
dT
"}
(36,1,1) = {"
dT
dT
dT
dT
dT
dT
dT
dT
dE
rI
ki
rI
dE
dT
dT
dT
dE
rI
ki
rI
dE
dT
dT
dT
dT
"}
(37,1,1) = {"
dT
dT
dT
dT
dT
dT
dT
dT
dE
kf
dE
kf
dE
dT
dT
dT
dE
kf
dE
kf
dE
dT
dT
dT
dT
"}
